7 7 7 7 7 7 7 7 7 7 7 7 7 7 7 7 7 7 7 7 7 7 7 7 7 7 7 7 7 7 7 7
7 1 1 1 1 1 1 1 34 34 1 1 1 1 1 1 1 1 1 1 1 1 1 1 1 1 1 1 1 1 1 7
7 1 1 1 1 1 1 1 34 34 1 1 1 1 1 1 1 1 34 34 34 1 30 30 1 30 30 1 1 1 1 7
7 1 1 1 1 1 1 1 34 34 1 1 1 1 1 1 1 1 34 34 34 1 30 30 30 30 30 1 1 1 1 7
7 1 1 1 1 1 1 1 34 34 1 1 1 1 1 1 1 1 34 34 34 30 30 30 30 30 30 30 1 1 1 7
7 1 1 1 1 1 1 1 34 34 1 1 1 1 1 1 1 1 34 34 34 30 30 30 30 30 30 30 1 1 1 7
7 1 1 1 1 1 1 1 34 34 1 1 1 1 1 1 1 1 34 34 34 1 30 30 30 30 30 1 1 1 1 7
7 34 34 67 67 34 34 34 34 34 34 34 34 34 34 67 67 34 34 34 34 1 30 30 30 30 30 1 1 1 1 7
7 1 1 1 1 1 1 1 34 34 1 1 1 1 1 1 1 1 34 34 34 1 30 30 30 30 30 1 1 1 1 7
7 1 1 1 1 1 1 1 34 34 1 1 1 1 1 1 1 1 34 34 34 1 1 30 30 30 1 1 1 1 1 7
7 1 1 1 1 1 1 1 34 34 1 1 1 1 1 1 1 1 34 34 34 1 1 30 30 30 1 1 1 1 1 7
7 1 1 1 1 1 1 1 34 34 1 1 1 1 1 1 1 1 34 34 34 1 1 1 30 1 1 1 1 1 1 7
7 1 1 1 1 1 1 1 34 34 1 1 1 1 1 1 1 1 34 34 34 1 1 1 1 1 1 1 1 1 1 7
7 1 1 1 1 1 1 1 34 34 1 1 1 1 1 1 1 1 34 34 34 1 1 1 34 34 1 1 1 1 1 7
7 1 1 1 1 1 1 1 34 34 1 1 1 1 1 1 1 1 34 34 34 1 1 1 34 34 1 1 1 1 1 7
7 1 1 1 1 1 1 1 34 34 1 1 1 1 1 1 1 1 34 34 34 1 1 1 34 34 1 1 1 1 1 7
7 1 1 1 1 1 1 1 34 34 1 1 1 1 1 1 1 1 34 34 34 1 1 1 34 34 1 1 1 1 1 7
7 1 1 1 1 1 1 1 34 34 1 1 1 1 1 1 1 1 34 34 34 1 1 1 34 34 1 1 1 1 1 7
7 34 34 67 67 34 34 34 34 34 34 34 34 34 67 67 34 34 34 34 34 34 34 34 34 34 34 34 34 34 34 34
7 34 34 34 34 34 34 34 34 34 34 34 34 34 34 34 34 34 34 34 34 34 34 34 34 34 34 34 34 34 34 34
7 1 1 1 1 1 1 1 34 34 1 1 1 1 1 1 1 1 34 34 34 1 1 1 34 34 1 1 1 1 1 7
7 1 1 1 1 1 1 1 34 34 1 1 1 1 1 1 1 1 34 34 34 1 1 1 34 34 1 1 1 1 1 7
7 1 1 1 1 1 1 1 34 34 1 1 1 1 1 1 1 1 34 34 34 32 32 32 34 34 1 1 1 1 1 7
7 1 1 1 1 1 1 1 34 34 1 1 1 1 1 1 1 1 34 34 34 32 32 32 34 34 1 1 1 1 1 7
7 1 1 1 1 1 1 1 34 34 1 1 1 1 1 1 1 1 34 34 34 32 32 32 34 34 1 1 1 1 1 7
7 1 1 1 1 1 1 1 34 34 1 1 1 1 1 1 1 1 34 34 34 1 1 1 34 34 1 1 1 1 1 7
7 1 1 1 1 1 1 1 34 34 1 1 1 1 1 1 1 1 34 34 34 34 34 34 34 34 1 1 1 1 1 7
7 1 1 1 1 1 1 1 34 34 1 1 1 1 1 1 1 1 34 34 34 34 34 34 34 34 1 1 1 1 1 7
7 34 34 67 67 34 34 34 34 34 34 34 34 34 67 67 34 34 34 34 34 34 34 34 34 34 1 1 1 1 1 7
7 34 34 34 34 34 34 34 34 34 34 34 34 34 34 34 34 34 34 34 34 34 34 34 34 34 1 1 1 1 1 7
7 1 1 1 1 1 1 1 1 1 1 1 1 1 1 1 1 1 1 1 1 1 1 1 1 1 1 1 1 1 1 7
7 7 7 7 7 7 7 7 7 7 7 7 7 7 7 7 7 7 7 7 7 7 7 7 7 7 7 7 7 7 7 7