1 1 1 1 1 1 1 1 1 1 1 1 1 1 1 1 1 1 1 1 1 1 1 1 1 1 1 1 1 1 1 1
1 1 1 1 1 1 1 1 1 1 1 1 1 1 1 1 1 1 1 1 1 1 1 1 1 1 1 1 1 1 1 1
1 1 1 1 1 1 1 1 1 1 1 1 1 1 1 1 1 1 1 1 1 1 1 1 1 1 1 1 1 1 1 1
1 1 1 1 1 1 1 1 1 1 1 1 1 1 1 1 1 1 1 1 1 1 1 1 1 1 1 1 1 1 1 1
1 1 1 1 1 1 1 1 1 1 1 1 1 1 1 1 1 1 1 1 1 1 1 1 1 1 1 1 1 1 1 1
1 1 1 1 1 1 1 1 1 1 1 1 1 1 1 1 1 1 1 1 1 1 1 1 1 1 1 1 1 1 1 1
1 1 1 1 1 1 1 1 1 1 1 1 1 1 1 1 1 1 1 1 1 1 1 1 1 1 1 1 1 1 1 1
1 1 1 1 1 7 7 7 7 7 7 7 7 1 1 7 7 7 7 7 7 7 7 7 7 7 1 1 1 1 1 1
1 1 1 1 1 7 3 2 2 2 2 2 2 1 1 2 2 2 2 2 2 2 2 2 12 7 1 1 1 1 1 1
1 1 1 1 1 7 5 38 36 36 36 36 36 36 36 36 36 36 36 36 36 36 36 42 13 7 1 1 1 1 1 1
1 1 1 1 1 7 5 37 0 0 0 0 0 0 43 0 0 0 0 0 0 0 0 35 13 7 1 1 1 1 1 1
1 1 1 1 1 7 5 37 0 0 0 0 0 0 43 43 43 43 43 43 0 0 0 35 13 7 1 1 1 1 1 1
1 1 1 1 1 7 5 37 0 0 0 0 0 0 0 0 0 0 0 43 0 0 0 35 13 7 1 1 1 1 1 1
1 1 1 1 1 7 5 37 0 0 0 0 0 0 0 0 0 0 0 43 0 0 0 35 13 7 1 1 1 1 1 1
1 1 1 1 1 7 5 37 0 0 0 0 0 0 0 0 0 0 0 43 0 0 0 35 13 7 1 1 1 1 1 1
1 1 1 1 1 7 5 39 40 40 40 40 40 40 40 40 40 40 40 40 40 40 40 41 13 7 1 1 1 1 1 1
1 1 1 1 1 7 4 2 2 2 2 2 2 2 2 2 2 1 1 1 2 2 2 2 11 7 1 1 1 1 1 1
1 1 1 1 1 7 7 7 7 7 7 7 7 7 7 7 7 1 1 1 7 7 7 7 7 7 1 1 1 1 1 1
1 1 1 1 1 31 31 31 31 33 1 1 1 1 1 1 1 1 1 1 1 33 31 31 31 31 1 1 1 1 1 1
1 1 1 32 32 32 32 1 32 32 32 32 1 32 32 32 32 1 1 1 1 1 30 30 1 1 30 30 1 1 1 1
1 1 1 32 1 1 32 1 32 1 1 32 1 32 1 1 32 1 1 1 1 1 30 1 30 30 1 30 1 1 1 1
1 1 1 32 1 1 32 1 32 1 1 32 1 32 32 32 32 1 1 1 1 1 30 1 1 1 1 30 1 1 1 1
1 1 1 32 1 1 32 1 32 1 1 32 1 32 1 1 1 1 1 1 1 1 1 30 1 1 30 1 1 1 1 1
1 1 1 32 32 32 32 1 32 32 32 32 1 32 1 1 1 1 1 1 1 1 1 1 30 30 1 1 1 1 1 1
1 1 1 1 1 1 1 1 1 1 1 1 1 1 1 1 1 1 1 1 1 1 1 1 1 1 1 1 1 1 1 1
1 1 1 1 1 1 1 1 1 1 1 1 1 1 1 1 1 1 1 1 1 1 1 1 1 1 1 1 1 1 1 1 
1 1 1 1 1 1 1 1 1 1 1 1 1 1 1 1 1 1 1 1 1 1 1 1 1 1 1 1 1 1 1 1
1 1 1 1 1 1 1 1 1 1 1 1 1 1 1 1 1 1 1 1 1 1 1 1 1 1 1 1 1 1 1 1
1 1 1 1 1 1 1 1 1 1 1 1 1 1 1 1 1 1 1 1 1 1 1 1 1 1 1 1 1 1 1 1
1 1 1 1 1 1 1 1 1 1 1 1 1 1 1 1 1 1 1 1 1 1 1 1 1 1 1 1 1 1 1 1
1 1 1 1 1 1 1 1 1 1 34 1 1 1 1 1 1 1 1 1 1 1 1 1 1 1 1 1 1 1 1 1
1 1 1 1 1 1 1 1 1 1 34 1 1 1 1 1 1 1 1 1 1 1 1 1 1 1 1 1 1 1 1 1