93 93 93 93 116 0 0 117 7 7 7 130 122 122 122 122 122
93 93 93 93 116 0 0 117 1 1 30 130 122 122 122 122 122
93 93 93 93 116 0 0 117 1 1 1 130 122 122 122 122 122
93 93 93 93 93 116 0 117 1 1 30 130 122 122 122 122 122
93 93 93 93 93 116 0 119 121 121 121 131 123 123 123 123 123
93 93 93 116 0 0 0 0 0 0 0 124 124 124 124 124 124
93 93 93 116 0 0 0 0 0 0 0 124 124 124 124 124 124
93 93 93 116 0 0 0 118 120 120 120 128 127 125 125 125 125
93 93 93 116 0 0 0 117 30 1 1 129 126 122 122 122 122
93 93 93 116 0 0 0 117 1 1 30 129 126 122 122 122 122
93 93 93 116 0 0 0 117 1 1 1 129 126 122 122 122 122
93 93 93 116 0 0 0 117 7 7 7 129 126 122 122 122 122