82 82 82 85 91 91 91 91 91 91 91 91 91 91 91 94 87
84 84 84 86 82 82 82 101 103 82 82 82 82 82 82 98 99
87 87 87 88 95 95 95 102 104 95 108 115 95 95 95 95 100
87 88 96 97 89 92 92 92 92 109 110 111 92 92 92 92 92
87 88 84 84 89 92 92 92 92 92 112 113 92 92 92 92 92
87 88 87 106 107 92 92 112 93 93 93 93 93 93 93 93 93
87 88 87 89 92 92 92 112 93 93 93 93 93 93 93 93 93
87 88 87 89 92 92 92 112 93 93 93 93 93 93 93 93 93
87 88 87 89 92 92 92 112 93 93 93 93 93 93 93 93 93
87 88 87 89 92 92 92 112 93 93 93 93 93 93 93 93 93
87 88 87 89 92 92 92 112 93 93 93 93 93 93 93 93 93
87 88 87 89 92 92 92 112 93 93 93 93 93 93 93 93 93