15 15 15 15 15 15 15 15 15 15 15 15 15 15 15 15 15 23 21 14 14 14 15 15 15 15 15 15 15 15 15 15
15 15 15 15 15 15 15 15 15 8 15 15 15 15 15 15 15 23 21 14 14 14 15 15 15 15 15 15 15 15 15 15
26 26 26 26 26 26 26 26 26 15 15 15 15 15 15 25 15 23 21 14 14 14 15 15 15 15 15 15 15 15 15 15
27 27 27 27 27 27 27 27 27 15 15 25 15 15 15 15 15 23 21 14 14 14 15 15 15 25 15 15 15 15 15 15
15 15 25 25 15 15 15 15 15 15 15 15 15 15 15 16 15 23 21 14 14 14 15 15 15 15 15 15 15 15 15 15
15 15 15 15 15 15 15 15 15 15 15 15 15 15 15 15 15 23 21 14 14 14 15 15 15 15 15 15 15 15 15 15
15 15 15 15 15 15 25 15 15 15 15 15 25 15 15 15 15 23 21 14 14 14 15 15 15 15 15 15 15 15 15 15
24 24 24 15 15 15 15 25 15 15 15 15 15 15 15 15 15 23 21 14 14 14 15 15 15 16 15 15 15 15 15 15
22 22 22 24 15 15 15 15 15 15 15 15 15 15 15 15 15 23 21 14 14 14 15 15 15 15 15 15 15 15 15 15
14 14 14 22 24 24 24 15 16 15 15 15 15 15 15 15 15 23 21 14 14 14 15 15 15 15 15 15 15 15 15 15
14 14 14 14 22 22 22 24 24 24 24 24 15 15 15 15 15 23 21 14 14 14 15 15 15 15 15 15 15 15 15 15
14 14 14 14 14 14 14 22 22 22 22 22 24 24 24 15 15 23 21 14 14 14 15 15 15 15 15 15 15 15 15 15
14 14 14 14 14 14 14 14 14 14 14 14 14 14 14 24 24 15 21 14 14 14 14 14 14 14 14 14 14 14 14 14
14 14 14 14 14 14 14 14 14 14 14 14 14 14 14 14 14 14 14 14 14 14 14 14 14 14 14 14 14 14 14 14
14 14 14 14 14 14 14 14 14 14 14 14 14 14 14 14 14 14 14 14 14 14 14 14 14 14 14 14 14 14 14 14
14 14 14 14 14 14 14 14 14 14 14 14 14 14 14 14 14 14 14 14 14 14 14 14 14 14 14 14 14 14 14 14
14 14 14 14 14 14 14 14 14 14 14 14 14 14 14 14 14 14 14 14 14 14 14 14 14 14 14 14 14 14 14 14
14 14 14 14 14 14 14 14 14 14 14 14 14 14 14 14 14 14 14 14 14 14 14 14 14 14 14 14 14 14 14 14
14 14 14 14 14 14 14 14 14 14 14 14 14 14 14 14 14 14 14 14 14 14 14 14 14 14 14 14 14 14 14 14
14 14 14 14 14 14 14 14 14 14 14 14 14 14 14 14 14 14 14 14 14 14 14 14 14 14 14 14 14 14 14 14
14 14 14 14 14 14 14 14 14 14 14 14 14 14 14 14 14 14 14 14 14 14 14 14 14 14 14 14 14 14 14 14
14 14 14 14 14 14 14 14 14 14 14 14 14 14 14 14 14 14 14 14 14 14 14 14 14 14 14 14 14 14 14 14
14 14 14 14 14 14 14 14 14 14 14 14 14 14 14 14 14 14 14 14 14 14 14 14 14 14 14 14 14 14 14 14
14 14 14 14 14 14 14 14 14 14 14 14 14 14 14 14 14 14 14 14 14 14 14 14 14 14 14 14 14 14 14 14
14 14 14 14 14 14 14 14 14 14 14 14 14 14 14 14 14 14 14 14 14 14 14 14 14 14 14 14 14 14 14 14
14 14 14 14 14 14 14 14 14 14 14 14 14 14 14 14 14 14 14 14 14 14 14 14 14 14 14 14 14 14 14 14
14 14 14 14 14 14 14 14 14 14 14 14 14 14 14 14 14 14 14 14 14 14 14 14 14 14 14 14 14 14 14 14
14 14 14 14 14 14 14 14 14 14 14 14 14 14 14 14 14 14 14 14 14 14 14 14 14 14 14 14 14 14 14 14
14 14 14 14 14 14 14 14 14 14 14 14 14 14 14 14 14 14 14 14 14 14 14 14 14 14 14 14 14 14 14 14
14 14 14 14 14 14 14 14 14 14 14 14 14 14 14 14 14 14 14 14 14 14 14 14 14 14 14 14 14 14 14 14
14 14 14 14 14 14 14 14 14 14 14 14 14 14 14 14 14 14 14 14 14 14 14 14 14 14 14 14 14 14 14 14