1 1 1 1 1 1 1 1 1 1 1 1 1 1 1 1 1 1 1 1 1 1 1 1 1 1 1 1 1 1 1 1
1 1 1 1 1 1 1 1 1 1 1 1 1 1 1 1 1 1 1 1 1 1 1 1 1 1 1 1 1 1 1 1
1 1 1 1 1 1 1 1 1 1 1 1 1 1 1 1 1 1 1 1 1 1 1 1 1 1 1 1 1 1 1 1
1 1 1 1 1 1 1 1 1 1 1 1 1 1 1 1 1 1 1 1 1 1 1 1 1 1 1 1 1 1 1 1
1 1 1 1 1 1 1 1 1 1 1 1 1 1 1 1 1 1 1 1 1 1 1 1 1 1 1 1 1 1 1 1
1 1 1 1 1 1 1 1 1 1 1 1 1 1 1 1 1 1 1 1 1 1 1 1 1 1 1 1 1 1 1 1
1 1 1 1 1 1 1 1 1 1 1 1 1 1 1 1 1 1 1 1 1 1 1 1 1 1 1 1 1 1 1 1
1 1 1 1 1 7 7 7 7 7 7 7 7 7 7 7 7 7 7 7 7 7 7 7 7 7 1 1 1 1 1 1
1 1 1 1 1 7 3 2 2 2 2 2 2 2 2 2 2 2 2 2 2 2 2 2 12 7 1 1 1 1 1 1
1 1 1 1 1 7 5 0 0 0 0 0 0 0 0 0 0 0 0 0 0 0 0 0 13 7 1 1 1 1 1 1
1 1 1 1 1 7 5 0 0 0 0 0 0 0 0 0 0 0 0 0 0 0 0 0 13 7 1 1 1 1 1 1
1 1 1 1 1 7 5 0 0 0 0 0 0 0 0 0 0 0 0 0 0 0 0 0 13 7 1 1 1 1 1 1
1 1 1 1 1 7 5 0 0 0 0 0 0 0 0 0 0 0 0 0 0 0 0 0 13 7 1 1 1 1 1 1
1 1 1 1 1 7 5 0 0 0 0 0 0 0 0 0 0 0 0 0 0 0 0 0 13 7 1 1 1 1 1 1
1 1 1 1 1 7 5 0 0 0 0 0 0 0 0 0 0 0 0 0 0 0 0 0 13 7 1 1 1 1 1 1
1 1 1 1 1 7 5 0 0 0 0 0 0 0 0 0 0 0 0 0 0 0 0 0 13 7 1 1 1 1 1 1
1 1 1 1 1 7 4 2 2 2 2 2 2 2 2 2 2 1 1 1 2 2 2 2 11 7 1 1 1 1 1 1
1 1 1 1 1 7 7 7 7 7 7 7 7 7 7 7 7 1 1 1 7 7 7 7 7 7 1 1 1 1 1 1
1 1 1 1 1 31 31 31 31 1 1 1 1 1 1 1 1 1 1 1 1 1 31 31 31 31 1 1 1 1 1 1
1 1 1 32 32 32 32 1 32 32 32 32 1 32 32 32 32 1 1 1 1 1 30 30 1 1 30 30 1 1 1 1
1 1 1 32 1 1 32 1 32 1 1 32 1 32 1 1 32 1 1 1 1 1 30 1 30 30 1 30 1 1 1 1
1 1 1 32 1 1 32 1 32 1 1 32 1 32 32 32 32 1 1 1 1 1 30 1 1 1 1 30 1 1 1 1
1 1 1 32 1 1 32 1 32 1 1 32 1 32 1 1 1 1 1 1 1 1 1 30 1 1 30 1 1 1 1 1
1 1 1 32 32 32 32 1 32 32 32 32 1 32 1 1 1 1 1 1 1 1 1 1 30 30 1 1 1 1 1 1
1 1 1 1 1 1 1 1 1 1 1 1 1 1 1 1 1 1 1 1 1 1 1 1 1 1 1 1 1 1 1 1
1 1 1 1 1 1 1 1 1 1 1 1 1 1 1 1 1 1 1 1 1 1 1 1 1 1 1 1 1 1 1 1 
1 1 1 1 1 1 1 1 1 1 1 1 1 1 1 1 1 1 1 1 1 1 1 1 1 1 1 1 1 1 1 1
1 1 1 1 1 1 1 1 1 1 1 1 1 1 1 1 1 1 1 1 1 1 1 1 1 1 1 1 1 1 1 1
1 1 1 1 1 1 1 1 1 1 1 1 1 1 1 1 1 1 1 1 1 1 1 1 1 1 1 1 1 1 1 1
1 1 1 1 1 1 1 1 1 1 1 1 1 1 1 1 1 1 1 1 1 1 1 1 1 1 1 1 1 1 1 1
1 1 1 1 1 1 1 1 1 1 1 1 1 1 1 1 1 1 1 1 1 1 1 1 1 1 1 1 1 1 1 1
1 1 1 1 1 1 1 1 1 8 1 1 1 1 1 1 1 1 1 1 1 1 1 1 1 1 1 1 1 1 1 1